64
16
0000000000000000000000000000000000000000000000000000000000000000
0000000000000000000000000000000000000000000000000000000000000000
0000000000000000000000000000000000000000000000000000000000000000
000000000000000000000000000000000000t000000000000000000000000000
00000000000000000000000000000000000000t0000000000000000000000000
0000000000000000000000000000000000000000000000000000000000000000
0000000000000000000000000000000000000000000000000000000000000000
0000000000000000000000000000000000231145000000000000000000000000
00000000t00000000000000t0000000023111111450000000000000000000000
0000000000000000000000000000002311111111114500000000000000000000
0000t00000230111145000t000002311111111111111450000000000000t0000
t00000002300011111145000002311111111111111111145000000t0000000t0
00t000230000011111111111111111111111111111111111450000000t000000
00@02300000011111111111111111111111111111111111111450000000d0000
1111111111111111111111111111111111111111111111111111111111111111
1111111111111111111111111111111111111111111111111111111111111111
*--------------------------------------------------------------*
0000000000000000000000000000000000000000000000000000000000000000
0000000000000000000000000000000000111000000000000000000000000000
0000000000000000000000000000000000111000000000000000000000001110
0000000000000000000000000000000000111000000000000000000000001110
0000011100000000000000000000000000111000000000000000000000001110
0000011110000000000000000000000000111000000000000000000000001110
0000011110000000000000000000000000111000000000011100000000001110
0000011110000000000000000000000000111000000000011100000000001110
0000011110000000000011100000000000111000000000011100000000011110
0000011110000000000011100000000000111000000000011100000000011110
0000011110000000000011100000000000111000000000011100000000011110
0000011110000000000011100000000000111000000000011110000000011110
0000011110000000000011100000000000111000000000011110000000111110
0000011110000000000011100000000000111000000000011110000000111110
0000011110000000000011100000000000111000000000011110000000111110
0000011110000000000011100000000000111000000000011110000000111110
