216
16
000000000000000000000000000000000000000000000000000000000000000000000000000000000001110000000000000000000000000000000000000000000000000000000000000000000000000000000000000000000000000000000000000000000000000000000000
000000000000000000000000000000000000000000000000000000000000000000000000000000000001110000000000000000000000000000000000000000000000000000000000000000000000000000000000000000000000000000000000000000000000000000000000
0000000000000000000000000000000000000000000000000000000000000000000000000000t0000001110000000000000000000000000000000000000000000000000000000000000000000000000000000000000000000000000000000000000000000000000000000000
000000000000000000000000000000000000000000000000000000000000000000000000000000000001110000000000000000000000000000000000000000000000000000000000000000000000000000000000000000000000000000000000000000000000000000000000
000000000000000000000000000000000000000000000000000000000000000000000000000t00000001110000000000000000000000000000000000000000000000000000000000000000000000000000000000000000000000000000000000000000000000000000000000
000000000000000000000000000000000000000000000000000000000000t00000000000000000000001110000000000000000000000000000000000000000000000000000000000000000000000000000000000000000000000000000000000000000000000000000t00000
000000000000000000t000000000000000000000000000000000t000t0000t0000000000011111fffff11100000000000000000000000000000000000000000000000000000000000000000000000000000000000000000000000000000000000000000000000000000000t0
00000000000000000000000000t00000000t000000000t0000000000000e1111000000000111110000001100000000000000000000000000000000000000000000t00000000000000000000000000000000000000000000000000000000000000000000ff00000000t000t00
00t000000000000000000000000000000000000000000000t000000011111111t00000t00111110000000000000000000000000000000t000000t00000000000t000000000000000000000000000000000000000ff0000000000000000000ff000000000000000000000d000
00000t000000000t0000000000000011fff110000000000000t00000111111110000000t011111000000000000000000000000000000000t00000e000000000e0e0e000000000ffff000000000000000000e00000000000000ff000000000000000000000000000000111111
0t00000000t00000001100000011001100011000e0e0011111111111111101111t000t00011111000000000000000000000000000000t000000t111000000011111110000000000000000000fff0000000011000000000000000000000000000000000000000000000111111
00@000000000000001110000011100110001100111100111111111111111111111000001111111000000t0000000000fff0000000000000e00t01110000000111111100000000000000000000000000000011000000000000000000000000000000000000000000001111111
111111111111111111111111111111111111111111111111111111111111111111111111111111111111111111111111111111111111111111111111111111111111111111111111111111111111111111111111111111111111111111111111111111111111111111111111
111111100011000111111111111111110001100101100111110011111011110111111111111111001111110000000000000000000000111111111110000000111111100000000000000000000000000000011000000000000000000000000000000000000000000001111111
111101111111000111011111101111110001100111100111111111111111111110111111111011001111110000000000000000000000111111111110000000111111100000000000000000000000000000011000000000000000000000000000000000000000000001111111
111111111111000111111111111111110001100111100111111111111111111111111111111111^^1111110000000000000000000000111111111110000000111111100000000000000000000000000000011000000000000000000000000000000000000000000001111111
*----------------------------------------------------------------------------------------------------------------------------------------------------------------------------------------------------------------------*
000000000000000000000000000000000000000000000000000000000000000000000000000000000000000000000000000000000000000000000000000000000000000000000000000000000000000000000000000000000000000000000000000000000000000000000000
000000000000000000000000000000000000000000000000000000000111000000000000011100000000000000000000000000000000000000000000000000000000000000000000000000000000000000000000000000000000000000000000000000000000000000000000
111000000000000000000000000000000000000000000000000000000111000000000000011100000000011000000000000000000000000000000000000111000000000000000000000000000000000000000000000000000000000000000000000000001110000000000111
111000000000000000000000000000000000000000000000000000000111000000000111011100000000001110000000000000000000000000000000000111000000000000000000000000000000000000000000000000000000000111000000000000001110000000000111
111000000000000000000000000000000000111000000000000000000111000000000111011110111000001110000000000000000000000000000000000111000000000000000000000000000000000000000000000000000000000111000000000000001110000000000111
111000001110000000000000000000000001111000000001110000000111000000000111011110111000001111000000000000000000000000000111000111000000000000111000000000000011100000000000000000000000000111100000000000001110000000000111
111000001110000000000000011100000011111000000001110000000111000000001111011110111001001111000000000000000000000000000111000111100000000000111000000000000111100000001110000000000000000111100000000000001110000011100111
111000011110000000000000111100000011111000000001110000000111000000011111010000111101101111000001110000000000000000000111000111100000000000111000000000000111100000001110000000011100000111100000000000001110000011101111
111000111110000000000001111100000011111000000001110000000111000000011111010001111101111111000001110000000000000000000111000111100000000000111000000000000111100000001110000000011100000111100000000000001110000011101111
111000111110000000000001111110000011111100000001111000000000000000111111010000111110011111000011110000000000000000000111000111100000000000111000000000000111100000001110000000011100000111100000000000001110000111111111
111100111110000000000001111110000010011110000001111000000001100001111111010000111111001111000011110000000000000000000111000111100000000000111100000000000111100000001110000000011100000111100000111000001110000111110000
111101111110001110000011111111000010011010000001111000000000100001111111010001111111001111000011110000000111000000000011000111100000000000111100000000000111100000001110000000011100000111100000111000001110000111100000
111101111111001110000111110011000010011010000001111000011100000000111111010001111111011111100011110000001111000000000011000111100000110000111100000000000111100000001110000000011100000111100000111000001110000111100000
000000111111101110000111110011000110011010000001111000011100001101011100000001111011011111100011110000001111000000000011000111100000111000111100000000000111110000001110000000011100000111100000111000001110000111100000
000000111110101110000111110000000110011010000001111000011100001111001100001101111000011111100011111000001111000000000011000111100000011000111100000000000111110000001110000000011100000111100001111000001110000111100000
000000111110101110000000010000001111011000000001111000011100000001001000000101111000011111100011111000001111000000000011000111100000011000111100000000000111110000001110000000011100000111100001111000001110000111100000
